***************
*  **         *
*    **       *
P     *       F
*    #****#****
*  *          *
*  *          *
***************