***************
*  **         *
*    **       *
P     # *     F
*    ** ** ****
*         #   *
*  *          *
***************